academic	adj. 學院的，理論的
accelerate	v. 加速，增速，進行，迫使
accentuate	v. 重讀，強調，
access	n. 接近，通路，入門
accidental	adj. 偶然的， 意外的
acclaim	v. 喝彩，歡呼，稱讚
accommodate	v. 供應，容納
accompany	v. 伴隨，陪伴
accomplice	n.從犯，幫兇，同謀
accomplished	adj. 完成的，熟練的
accost	v. 向人搭話
account	n. 描述，原因，戶頭，賬目
accredit	vt. 歸功於，認為
accumulate	v. 積聚
accurate	adj. 準確的，正確的
accusation	n.控告，指責，譴責
accuse	v. 控告，歸咎
accustom	v. 習慣
achieve	v. 完成，實現，達到
acid	adj.酸的，尖酸的，刻薄的
acknowledge	v. 承認，屬實，供認
acquire	v. 獲得，得到
acquisitive	adj. 貪得無厭的，可獲得的
acquit	adj. 宣告無罪
acrid	adj. 辛辣的，尖刻的， 刻薄的
acrimonious	adj. 尖酸的，刻薄的
acrimony	n. 刻薄，暴烈，尖刻
acting	adj. 代理的
action	n. 作用，行動
active	adj. 活動的，活躍的
actual	adj. 實際的，現行的
acumen	n. 敏銳, 精明，聰明
acute	adj. 敏銳的，急性的
adage	n. 格言，諺語
adapt	v. 使適應，改編
adaptable	adj. 能適應的， 可改寫的
adaptation	n. 適應，改寫
addict	v. 對…有隱，沉溺於...著
addicted	adj. 沉溺的，上癮的
adept	adj.擅長的，熟練的
adequate	adj. 足夠的，充分的
adhere	v. 黏著，粘附，堅持
adherence	n. 依附的，信奉的
adhesive	n. 粘著的，粘著物
adjacent	adj. 鄰近的，附近的，毗連的
adjoin	v. 貼近，靠近
adjoining	adj. 接近的，鄰近的，相連的
adjourn	v. 延期，停止，休會
adjust	v. 調節，使適於
administer	v. 管理，照料， 執行
administration	n. 行政，管理部門
admirable	adj.可敬的，極好的，令人欽佩的
admire	v. 欽佩，讚美，誇獎
admit	v.承認
admonish	v.警告，勸告，提醒
adopt	v. 採用， 收養
adore	v. 敬愛， 極喜愛
adroit	adj. 熟練的，機敏的，靈巧的
advance	n. 提出，前進
adverse	adj. 敵對的，不利的， 相反的
adversity	n. 不幸，逆境
advice	n. 建議， 忠告
advisable	adj. 合理的，可取的，適當的
advise	v. 告知，勸告
advocate	n. 辯護著，擁護
aesthetic	adj. 審美的，美學的
affable	adj. 和藹可親的
affect 	vt. 影響，感動
affection	n.愛，情感
affectionate	adj. 摯愛的，親切的
affiliate	v.加盟，入會
affinity	n.類似處，密切關係
affirm	v. 斷言，比准，證實
afflict	vt. 使痛苦，折磨
afflicting	痛苦的
affluence	n. 豐富，富裕，流入
affluent	adj.富裕的
afford 	v. 付的起，提供
age	v.老化
aged	adj.成年的，老年的
agenda	n.議程
aggravate	v. 惡化，加重
aggregate	n.總數，總計
aggression	n. 侵犯，侵害
aggressive	adj.好鬥的，
aghast	adj.驚駭的，恐怖的
agile	adj.敏捷的，活潑輕快的
agility	n. 敏捷，活潑
agitate	v. 煽動，攪動，激起
agonize	v. 使受苦，使苦悶
agrarian	adj. 土地的， 農業的
agreeable	adj. 宜人的，令人愉快的
aim 	v. 打算，意欲，目的，瞄準
alert	adj. 機敏的
algebra	n.代數
alien	n. 外國的， 陌生的
alienate	v. 使疏遠
alkali	n.鹼
allege	v. 宣稱，主張
allegiance	n. 忠誠
allegory	n. 諷喻，寓言
alleviate	v. 使減輕
alliance	n. 聯盟，同盟
allocate	vt. 分配，定位置
allot	v. 分配，指派
allude	v. 提及，暗指
allure	v. 引誘，誘惑，吸引
allusion	n.引示， 暗指
ally	v. 同盟，結盟
alone	adj. 單獨的
alter	v. 改變
alternate	n.替代物，v. 輪流,adj. 交替的
alternative	n.可選事務，adj.兩者條一的
altruism	n.利他主意
aluminium	n. 鋁
alumnus	n. 男校友
amalgamate	v. 混合，合併
amass	vt. 收集，積聚
amateur	n. 業餘的，業餘愛好者
amazed	adj. 驚愕的
ambiguous	adj. 含糊的，
ambitious	adj. 有野心的，雄心的
amenable	adj. 有責任的，肯接受的
amend	v. 修正，改進, 訂正
amiable	adj. 友善的，和藹的
amicable	adj. 和平的， 和善的
amount	n. 量，總數，數量
ample	adj. 充足的，足夠的
amplify	vt. 放大， 擴大
analogous	adj.類似的，相似的
analogy	n. 類似，類推
analysis 	n. 分析，分解，解析 （複數 analyses)
anecdote	n. 軼聞，軼事
angle	n.角度，角
anguish	n.極度的痛苦，苦悶，苦惱
animated	adj.有生氣的， 熱烈的，活躍的
annex	v. 附加，附件
annihilate	v. 銷減，殲滅
annotate	v. 註解
announce	v. 宣佈，通告
annoy	v. 使惱怒，打擾
annually	adv. 每年的
annul	vt. 廢除，取消
anomalous	adj. 反常的，不規則的
anomaly	n. 異立，異常，變態
anonymous	adj. 匿名的
antagonism	n. 敵對，對立，對抗
antagonist	n. 敵手，對手
anticipate	v. 預料，預期，期望
antique	adj. 古代的
antiquity	n. 古代
antiseptic	adj. 防腐的，殺菌的
anxious	adj. 渴望的
apathetic	adj.冷淡的
aperture	n. 孔，開口
apex	n. 頂點， 最高點
apologize	vi. 道歉
apparel	n. 服裝，衣服
appeal	n. 呼籲，申述
appear	vt. 出現，似乎
applaud	v. 喝彩，歡呼
applicant	n. 申請人
application	n. 請求，神情，施用
appoint	n.任命，委任， 約定，
appraise	v. 鑒定，評價
appreciate	v. 重視，感激
apprehend	v. 憂慮，畏懼，捕捉
apprehension	n. 擔心，害怕
apprentice	n.學徒
appropriate	adj. 適當的,恰當的,撥款,挪用,沒收
approve	v. 贊成，稱許，批准
approximate	adj.近似的，大約的
apt	adj. 有傾向的
aptitude	n. 才能，自然傾向
arable	adj. 適於耕種的
arbitration	n. 調停，仲裁
arbitrator	n. 仲裁著
archaic	adj. 古的
ardent	adj. 及熱情的，熱情的
ardor	n. 熱心
arduous	adj. 險峻的，困難的
arid	adj. 乾旱的
aristocrat	n. 貴族
arithmetic	n. 算術
armament	n. 兵力，軍力
armor	n. 裝甲，武器
aroma	n. 香氣， 芬芳，芳香
arouse	vt. 喚起
arrange	v. 排列
array	vt.裝扮，隊列，排列
arrogance	n. 傲慢
arrogant	adj. 傲慢的
article	n. 論文， 物品
ascend	v. 攀登， 攀高，追述
ascent	n. 攀登，上升
ascertain	vt. 確定，探知
ascetic	adj. 苦行的
aspect	n. 方面，樣子，外表
asperse	v. 誹謗
aspersion	n. 誹謗
aspiration	n. 熱望， 渴望
aspire	vi. 熱望
assail	vt. 猛擊，絕然面對
assassin	n. 刺客
assassinate	vt. 暗殺， 行刺
assault	v. 襲擊，攻擊
assemble	vt. 聚集
assembly	n. 集會
assert	v. 斷言，宣稱，維護
assess	vt. 估計
asset	n. 財產，財富
assiduous	adj. 勤勉的
assign	vt. 分配，指派
assimilate	v. 吸收
assist	v. 補助
associate	v. 聯合，夥伴
association	n. 協會，關聯
assuage	vt.緩和
assumption	n. 就職，假設
assure	vt. 使確信，向保證
astonish	vt. 使驚訝
astonished	adj. 驚訝的
astound	v. 使驚異
astronomy	n. 天文學
astute	adj. 機敏的，狡猾的
atheism	n. 無神論
athlete	n. 運動員
atmosphere	n. 氣氛，大氣層
atom	n.原子
attachment	n.連接物，附件
attainment	n. 成就
attend	vt. 參加
attendant	n. 侍者，服務人員
attorney	n. 代理人，辯護律師
at`tribute	v. 歸因於
`attribute	n. 性質
attrition	n. 磨損
audience	n.觀眾
audit	n. 審查，查賬
audition	n. 試聽， 面試
auditor	n.審計員，旁聽著
auditorium	n. 大禮堂，觀眾席
augment	v. 增大，增加
aura	n. 氣味，氣氛
auspices	n. 前兆，贊助，保護，主辦
auspicious	n. 吉兆的，幸運的
austerity	n. 節儉，嚴峻
authentic	adj. 可靠，又根據，真實的
authoritative	adj. 權威性的，官方的
authority	n. 權威
authorize	v. 授權
autocrat	n. 獨裁者
autonomy	n. 自治權
available	adj. 可用的
avalanche	n. v. 雪崩
avarice	n. 貪婪，貪財
avaricious	adj. 貪婪的， 貪心的
average	adj. 一般的，平均的
aversion	n. 厭惡
avert	v. 轉移，避免，防止
aviator	n. 飛行家，飛行員
avid	adj. 熱切的，貪婪的
avoid	vt. 避免。迴避，躲開
avow	v. 公開，承認
awe	n. v.  敬畏
awkward	adj. 笨拙的，尷尬的
axis	n.軸
baby-sit	v. 看管，照顧嬰兒
backward	adj. 退步的，相反的
baggage	n. 行李
bait	n. 誘餌
balance	n. 平衡
bald	adj. 禿頭的，光禿的
balk	v. 妨礙
ballot	n. 選票
balmy	adj. 溫和的，芳香的
ban	v. 禁止，禁令
bandit	n. 強盜
banish	vt. 驅逐出境
bankruptcy	n. 破產
banquet	n. 宴會
bar	n. 法院
barbarian	n. 野蠻人
bare	adj。 露出，空的
barely	adv. 僅僅
barometer	n. 氣壓計
barren	n. 貧瘠的，不孕的
barricade	n. 障礙物
barrier	n. 柵欄，屏障，障礙
barter	n.易貨，易貨貿易
bashful	adj. 害羞的，膽小的
basin	n. 盆地
bask	vt. 取暖，曬太陽，沐浴於
baste	vt. 毆打，公開責罵
batter	v. 擊破，搗壞，炮擊
bear	v. 具有，帶有，支撐
beat	adj. 疲倦的
becoming	adj. 合適的，相稱的
beforehand	adv. 事先的
befuddle	vt. 使混亂
beget	vt. 引起，產生
begrudge	vt. 羨慕，嫉妒
beguile	vt. 欺騙，消遣
behave	v. 舉止端正，表現，運轉
behaviour	n. 行為
belie	v. 掩飾
believer	n. 信徒
belittle	vt. 輕視
belligerent	adj. 好戰的，交戰的
benefactor	n. 恩人，行善的人，捐助人 (女性，benefactress)
beneficial	adj. 有益的
beneficiary	n.受益者，受惠著
benefit	n. 利益，對有益處
benevolent	adj. 慈善的
benign	adj. 親切的，良好的
bent	n. 傾向，愛好
bequest	n. 遺產，遺傳
berate	vt. 痛罵
bereave	vt. 剝奪
beset	v. 包圍
besides	adj. 除了
besiege	vt. 圍，包圍
bestow	v. 贈與，利用
betray	vt. 背叛，洩露
beverage	n. 飲料
bewilder	vt. 迷惑，把弄糊塗
bias	v. 偏見，使偏離
bicker	v. 爭吵
bidding	n. 邀請，投標，命令，要求
bigoted	adj. 固執己見的
bill	n. 鈔票，賬單，法案
biochemistry	n. 生物化學
bizarre	adj. 古怪的
blackmail	vt. 勒索 
blame	vt. 譴責
bland	adj.無刺激性的
blast	n. 一陣，爆破
bleach	v. 去色，漂白, 漂白劑
bleak	adj. 荒涼的
bleed	v. 流血
blemish	vt. 玷污
blend	v.n. 混合
blessed	adj. 愉快的， 神聖的
blessing	n. 祝福
blink	v. 眨眼
bliss	n. 狂喜
block	n. 一塊，阻礙，街區
blunder	v. 犯大錯
blunt	adj. 遲鈍的，使變鈍
board	n. 木板，委員會
boast	v. 自誇，吹噓
boastful	adj. 自誇的
bold	adj. 大膽的
bombastic	adj. 誇大的
bonanza	n. 富礦帶，幸運
bond	n.聯結，粘結，公債
bondage	n. 束縛
bonus	n. 紅利，獎金
boon	n. 恩惠
boredom	n. 煩惱， 無聊
boring	n. 令人厭煩的，鑽孔
botany	n. 植物學
bound	富有義務的，限制
boundary	n. 邊界
boundless	adj. 無限的
bow	v. n. 彎腰，屈服，弓子
brace	n. 支持，使固定，支撐物，
brag	n.v.誇張
brain	n. 腦，頭腦
brawl	n.vi.爭吵
breach	n. 破裂
breakdown	n. 崩潰，倒塌，失敗
breed	v. 養育，繁殖， 品種
breeze	n. 微風
brew	v. 釀造，圖謀
brighten	v. 使發光，使快活
brim	n. 邊
brink	n. 邊緣
brisk	adj. 活潑的,輕快的
brittle	adj. 易碎的
broaden	v. 放寬，變闊
bruise	v. 打傷，瘀傷
brutal	adj. 野蠻的
bud	v. 芽，發芽
budge	v. 移動
budget	v. 預算，做預算
bulk	n. 物體，容積，大批
bulky	adj. 龐大的，笨重的
burglar	n. 夜盜， 竊賊
burning	adj. 燃燒的，強烈的
burnish	vt. 磨光，使光滑
butt	n. 末端
butter	n. 奶油
byword	n. 諺語
calamity	n.不幸之事，災難
calculate	v. 計算，估計，計劃
calibre	n. 直徑，品質
cancel	vt. 取消
candidate	n. 候選人
canny	adj. 精明的，節儉的
canvas	n. 帆布
capable	adj. 有能力的
capacious	adj. 能容大量的
captivate	vt. 迷惑
captivity	n. 囚禁，拘留
carbon	n. 碳
cardinal	adj. 首要的，基本的
career	n. 生涯，職業
carnage	大屠殺，殘殺
carnal	adj.肉體的
castigate	v. 譴責
casual	adj. 非正式的，隨便的
casualty	n. 意外
cataclysm	n. 洪水， 大災難
catastrophe	n. 異常的災禍
catching	adj. 迷人的，傳染的
categorical	adj. 絕對的，無條件的
cathedral	n. 教堂
catholic	adj. 普遍的
cause	n. 導致，事業，原因
caustic	adj. 刻薄的，腐蝕性的
cautious	adj. 小心的，謹慎的
cavern	n. 大山洞，大洞穴
ceaseless	adj. 不停的
celebrity	n. 名人
celestial	adj. 天的
censor	n. 檢查，檢查員
censure	v. n. 責難
centigrade	adj. 攝氏的
ceremonial	adj. 儀式，正式的
ceremonious	adj. 隆重的，正式的，恭敬的
ceremony	n. 儀式
chafe	v. 擦熱，煩惱
chalk	n. 白堊，粉筆， 用粉筆寫
champion	v. 支持， n. 冠軍
chaos	n. 混亂
character	n. 性格，角色，文字
charge	v. 職責，收費，指控
charisma	n. 魅力，感召力
charitable	adj. 慷慨的，慈善的
charity	n. 施捨，慈善事業
chary	adj. 謹慎的，細心的
chaste	adj. 貞節的，純正的
chat	n. 閒談，聊天
check	vt. 檢查，核對
cherish	vi. 珍愛，撫愛
chide	v. 斥責
chiefly	adv. 主要的，多半的
chill	v. 使變冷，寒冷
chilly	adj. 寒冷的
chirp	n. 喳喳
choice	n. 選擇
choke	v.n. 窒息
choose	v. 選擇
chop	n. 砍，排骨
chore	n. 零工，雜物
chorus	n. 合唱團
Christian	n. 基督教徒。 Adj. 基督教的
chronic	adj. 長期的，慢性的
chuckle	vi. 咯咯的笑
cipher	n. 密碼
circuitous	adj. 迂迴的
circular	adj. 循環的，圓的
circulate	v. 使循環，循環
circulation	n. 循環
circumference	n. 圓周
circumscribe	v. 劃界限，限制
circumspect	adj. 慎重的，小心的
circumvent	vt. 欺詐，以計勝過
cite	vt. 引用，舉例
civilian	n. adj. 平民，平民的
clamour	n. 叫囂
clamp	v. 夾
clandestine	adj. 秘密的
clarify	v. 澄清， 闡明
clause	n. 分句，條款
clean	adv. 完全的
cleanse	v. 使清潔
cleft	n. 裂縫
clergy	n. 牧師
climate	n. 氣候
climax	n. 高峰，頂點
clinch	v. 釘牢，揪住
cling	vi. 粘附
clinic	n. 門診所
clip	n. 夾住，修剪，夾子，鉗子。
clog	v. 阻礙
close	adj. 親密的
clot	n. 凝塊
clothing	n. 衣服
clumsy	笨拙的，愚笨的
cluster	n. 束，叢生
clutch	v. 抓住，掌握
clutter	n. 混亂，使混亂
coarse	adj. 粗糙的，粗野的
coax	v. 哄， 耐心調理
coddle	v. 驕養，溺愛
cogent	adj. 強有力的，有說服力的
cohere	vt. 附著，連貫
coherent	adj. 連貫的
cohesion	n. 附著，結合，凝聚力
cohesive	adj. 有凝聚力的
coil	v. 盤繞，卷
coin	v. 鑄幣，創造
coincide	v. 相符合，相巧合
collaborate	vi. 合作
collapse	 n. v. 倒塌， 崩潰
collateral	n. 抵押品
colloquial	adj. 會話的，口語的
colossal	adj. 巨大的
combination	n. 化合，組合
comet	n.  彗星
commander	n. 司令官，指揮員
commence	v. 開始，獲得學位
commend	vt. 讚揚
commentator	n. 註釋著，解說員
commerce	n. 商業
commission	n. 委員會，佣金
committee	n. 委員會，委員
commodious	adj. 寬敞的
communicate	v. 通信，交流
community	n. 社區，社會，公社
compact	adj. 壓縮的，密集的
company	n. 夥伴
comparable	adj. 可比得，類似的
comparative	adj. 比較的
compare	v. 比較，比喻
compassion	n. 憐憫，同情
compatible	adj. 兼容的
compel	vt. 強迫
compensation	n. 補償，賠償
compete	vt. 競爭
competent	adj. 能勝任的
compile	v. 收集，編纂
complaint	抱怨，怨言，控告
complement	n. 補足物，補足
complementary	adj. adv. 補充的
complete	adj. 完全的，完成
complex	adj. 複雜的，綜合體
complicate	v. 使複雜，使陷入
compliment	n. 問候，讚美，祝賀
complimentary	adj. 讚美的
comply	vi.順從，應允
component	n. 組成部分
composed	adj. 沉著的
composure	n. 鎮靜
comprehend	vt. 理解
comprehensive	adj. 綜合的，有理解的
comprise	v. 包括
compulsive	adj. 強迫的
compulsory	adj. 義務的，必修的
conceal	v. 隱藏
concede	vt. 讓步，承認
conceit	n. 自負，自高自大
conceive	v. 想像，懷孕
concerned	adj. 焦慮的
concert	n.音樂會
concerted	adj. 協定的，協調的
concession	n. 讓步，牽就
conciliatory	adj. 善於調節的
concise	adj. 簡明的
conclude	v. 推斷出，斷定，結論
conclusive	adj. 決定的，最後的
concoct	v. 編造，虛構
concrete	adj. 具體的  n.水泥
concur	v. 同意，同時發生
concurrence	n. 一致
concurrent	adj. 同時發生的
condemn	vt. 譴責
condiment	n. 調味品
condition	n. 條件，狀況，健康情形
condone	v. 寬恕，赦免
con`duct	v. 引導
`conduct	n. 行為
cone	n. 圓錐
confederate	adj. n. 同盟
confer	v. 協商，頒給，賦予
conference	n. 會議，討論會
confess	v. 懺悔，坦白
confide	v. 傾訴
confidence	n. 信心
confident	adj. 確信的，自信的
confidential	adj.機密的
confine	n. 限制，邊界
confirm	v. 證實，確認
confiscate	vt. 沒收，充公
confound	vt. 使糊塗，迷惑
confuse	vt. 混淆
congenial	adj. 意氣相投的
congested	adj. 擁擠的
congregate	vt. 聚集
congressman	n.國會議員
congruity	n. 一致，協調
conjure	v. 變戲法，懇求
connivance	n. 默許
connive	vi. 縱容，默許
connoisseur	n. 鑒賞家，行家
conscience	n. 良心，良知
conscientious	adj. 盡職的，正直的
conscious	adj. 有意識的
consecrate	v. 奉為神聖，奉獻
consecutive	adj. 連續的
consensus	n. 一致
conservative	adj. 保守的，保守的人
conservatory	n. 溫室，音樂學校
conserve	vt. 貯藏
consider	vt. 考慮
considerable	adj. 相當的
considerate	adj. 考慮周到的
console	v. 安慰
consolidate	v. 合併
consort	vt. 結交
conspicuous	adj. 引人注目的
conspiracy	n. 陰謀
conspire	vt. 陰謀，密謀
constant	adj. 不變得
constellation	n. 星座
constitute	v. 構成
constrain	v.強迫
constrict	v. 收緊，壓縮
construct	vt. 建造，構造
construe	v. 解釋，翻譯
consult	v. 商量，請教
consume	v. 消費，消耗
consumer	n. 顧客，消費者
contagious	adj. 傳染的
container	n. 容器
contaminate	v. 污染
contempt	n. 蔑視
contemplate	v. 凝視，沉思
contemptible	adj. 可鄙的
contemptuous	adj. 苗似的，傲慢的
contend	v. 爭鬥
con`tent	adj. 滿足的
`content	n. 內容
continent	n. 大陸
contingent	adj. 可能發生的
continually	adv. 不斷的
contour	n. 輪廓，海岸線
`contract	n. 契約
con`tract	v. 收縮，感染
contradict	v. 反駁，牴觸
contrast	n. 對比
contravene	v. 反對，違反
contrite	adj. 悔悟的
contrive	v. 發明，設法
controversial	adj. 引起爭論的
controversy	n. 爭論
controvert	v. 反駁，辯論
convene	v. 集合
convenient	adj.便利的，方便的
convention	n. 會議，協定，傳統
conventional	adj. 傳統的，習俗的
convert	v. 轉換
convey	v. 運輸，表達
convict	v. 判罪，證明
convoy	n. 護送
cooperation	n.合作
coordinate	adj. 同等的，並列的
copper	n. 銅
copy	v. 複製，模仿
cordial	adj. 真誠的，誠懇的
corps	n. 軍團，兵團
corpse	n. 屍體
corpulent	adj. 肥胖的
correct	adj. 正確的，糾正
correlate	v. 相關聯
correspondence	n. 對應，符合，通信
corroborate	vt. 確證
corrode	v. 損害
cosmopolitan	adj. 全世界的
costume	n. 服裝
counsel	n. 商議，忠告，律師，勸告
counterfeit	n. adj. 偽造，假冒的，贗品
counterpart	n.相對物，及相似之物
countless	adj. 無數的
court	n. 法庭   v.追求
courteous	adj. 有禮貌的，謙恭的
cover	vt. 包括，報道
covetous	adj. 貪心的
cower	v. 畏縮的
cozy=cosy	adj. 舒適的
craft	n. 船，手藝
crafty	adj. 靈巧的，巧妙的
cram	v. 填塞，倉促用功
crash	n. v. 撞碎
crave	v. 渴求
crazy	adj. 狂熱的
credential	n. 憑證
credit	n. 信譽，學分
credulous	adj. 輕信的
creed	n. 信仰，信條
creek	n. 小灣，小溪
crevasse	n. 裂縫，破口
crew	n. 船員
crisp	adj. 脆的，捲曲的
critical	adj. 評論的，批評的，危及的,臨界的
crooked	adj. 扭曲的，狡詐的
crucial	adj. 嚴重的，極重要的
crude	adj. 未提煉的，生的
cruel	adj. 殘忍的
crumble	v. 粉碎，崩潰
crumple	v. 壓皺
crush	vt. 搾，擠，壓碎
crust	n. 地殼，硬外皮
cryptic	adj. 神秘的，隱藏的
crystal	n. 水晶，晶體，清澈的
cubic	adj. 立方體的
cuisine	n. 烹調
culmination	n. 頂點
culpable	adj. 該受譴責的
cult	n. 崇拜，崇拜者
cultivate	vt. 耕種，培養
cultivation	n. 耕種，培養
cunning	adj. 狡猾的，可愛的
curb	n. 抑制
curiosity	n. 好奇心
curious	adj. 好奇的
currency	n. 通貨，通用，市價
current	adj. 現今的，n. 流，趨勢
cursory	adj. 倉促的
curt	adj. 簡短的，草率的
curtail	vt. 縮減
cushion	n. 墊層，緩解
custom	n. 習慣，進口稅
cynical	adj. 譏諷的，冷嘲熱諷的
dab	n. 輕拍
dagger	n. 短劍
damp	adj. 潮濕的
dampen	v. 使潮濕，使沮喪
dangerous	adj. 危險的
dangle	v. 懸擺
dank	adj.陰濕的
daring	adj. 大膽的，勇敢的
dart	v. 投擲
dated	adj. 有年頭的，陳舊的
dauntless	adj. 勇敢的
daze	v. 混暈，使混暈，茫然
dazzle	v. 使目眩，使迷惑
dazzling	adj. 耀眼的
dead	adv. 完全的
deadly	adj. 致命的，極度的
deal 	vt. 處理，交易
debatable	adj. 爭論中的，未決定的
debt	n. 債務
debtor	n. 債務人
decadence	n. 衰落，頹廢
decay	vt. 腐敗
deceit	n. 欺騙，欺詐
deceitful	adj. 欺騙的
deceive	v. 欺騙，行騙
decent	adj. 正派的，體面的
deceptive	adj. 虛偽的，騙人的
decide	v. 決定
decimal	adj. 十進制的，小數
declaim	v. 朗誦，演講
decline	v. 衰落，拒絕
declivity	n. 下傾的斜面
decorum	n. 禮儀
decree	n. 法令，規定，頒布
decry	v. 危難，譴責
dedicate	vt. 奉獻，致力於
deem	v. 認為
defame	v. 誹謗，損毀名譽
default	n. 不履行責任，缺乏，不履行
defect	v. 缺陷
defection	n. 背叛，缺陷
defective	adj. 有缺陷的
defend	vt. 防護，辯護
defer	v. 延期
deference	n. 敬意
deferential	adj. 敬意的
defiant	adj. 大膽反抗的
deficit	n. 赤字
defile	v. 弄污
definite	adj. 明確的，肯定的
deflect	v. 使偏離
deform	v. 使變形
defraud	vt. 欺詐
deft	adj. 靈巧的，熟練的
defunct	adj.死的
defy	v. 蔑視，反抗
degenerate	n. 墮落的，退步
degrade	v. 使降級，使墮落
deity	n. 神
dejected	adj. 失落的，沮喪的
delay	v. 推遲，耽擱，延誤
delegate	n. 代表
delete	vt. 刪除
deleterious	adj. 有害的
deliberate	ad. 認真的，故意的
delicate	adj. 精巧的，脆弱的
delicious	adj. 美味的，宜人的
delineate	v. 刻畫，記述
delude	vt. 欺騙，迷惑
demise	n. 死亡
democracy	n. 民主
demolish	vt. 破壞
demonstrate	vt. 演示，論證
demur	vi. 躊躇，抗議
denote	vt. 指示，表示
denounce	vt. 譴責，聲討，告發
dense	adj. 密集的
density	n. 密度
deny	v. 否認
depart	vt. 離開，出發
dependent	adj. 依靠的，依賴的
depict	vt. 描寫，敘述
deplore	v. 悲痛，深悔
deport	vt. 驅逐出境，放逐，舉止
deposit	n. 放置，存款，押金
depot	n. 倉庫，容納
deprecate	vt. 抗議，攻擊
depreciate	v. 貶值
depress	v. 使沮喪
depression	n. 蕭條，凹陷，使沮喪
deputy	n. 代理人
derange	vt. 擾亂
deride	vt. 嘲笑，愚弄
desert	n. 沙漠，vt.離棄
deserve	v. 應得
design	n. 設計，圖案, v.設計
designate	v. 指定，指派
designing	adj. 狡猾的，蓄意的
desirable	adj. 理想的，如意的
desire	vt. 想要，慾望
desirous	adj. 渴望的
desolate	adj. 荒涼的
despatch=dispatch	n.迅速處理
despicable	adj. 可鄙的
despise	vt. 輕視，蔑視
despoil	vt. 爭奪，搶劫
dessert	n. 甜點
destination	n. 目的地
destine	vt. 指定，命運注定
destiny	n. 命運
destructive	adj. 破壞性的
detach	vt. 分開，分遣
detached	adj. 分離的，公正的
detain	v. 延遲，拘留
detect	vt. 探測，發掘
determination	n. 決定，決心
determine	v. 決定
deterrent	n. 制止物
detest	vt. 憎惡
detract	v. 去掉，減損
detriment	n. 損害
detrimental	adj. 有害的
devastate	vt. 毀壞
develop	vt. 發展，產生，成長
deviate	vt. 出軌，離題
device	n. 機械，裝置，設計
devious	adj. 曲折的
devise	vt.計劃，發明
devoid	adj. 缺乏的
devoted	adj. 熱心的
devotion	n. 獻身，忠誠，專心
devour	vt.吞食，吞沒，毀滅
devout	adj. 虔誠的
dexterous	adj. 靈巧的
diagnose	v. 診斷，分析
diagnosis	n. 診斷
diagram	n. 圖表
dialect	n. 方言，土語，地方話
dialogue	n. 對話
diameter	n. 直徑
dictatorial	adj. 獨裁的， 專斷的
diet	n. 飲食，食物，節食
diffuse	v. 傳播,擴散
dignified	adj. 尊嚴的，高貴的
dignify	vt. 使尊嚴，使顯貴
dignity	n. 尊嚴
digress	v. 離開本題
dilate	vt. 使膨脹，使擴大
dilemma	n. 左右為難，困境
diligent	adj. 勤勉的，勤奮的
dilute	v. 稀釋，沖淡
dim	adj. 昏暗的，朦朧的
dimension	n. 尺度，維
diminish	v. 減少，縮小
diminutive	adj. 小的
dingy	adj. 昏暗的，骯髒的
diplomacy	n. 外交，策略
diplomatic	adj. 外交的，策略的
direct	vt. 引導，直接的
disarm	v. 繳械，消除
disarming	adj. 消除敵意的
disarrange	v. 擾亂
disarray	n. 雜亂，混亂
disaster	n. 災難
disastrous	adj. 災難性的，悲慘的
disband	v. 解散
disburse	v. 支付，支出，分配
discard	vt.  丟棄
discerm	v. 辨明
discernible	adj. 可察覺的
discharge	v. 釋放
disciple	n. 門徒
disclaim	v. 拒絕承認
discord	n. 不和諧
discount	n. 折扣
discourse	n 演講，論文
discreet	adj. 慎重的,謹慎的
discrete	adj. 不連續的，離散的
discretion	n. 判斷力，慎重
discrimination	n. 歧視
disdain	n. 輕視，不懈，輕蔑
disfigure	v. 破壞
disgrace	v.不光彩的，丟臉的
disgust	n. 厭惡
disinterested	adj. 公正的
dismal	adj. 沮喪的，陰暗的
dismay	v. 使飢餓，使沮喪
disparage	vt. 輕視，譭謗
dispatch	vt. 分配，派遣
dispensable	adj. 可有可無的
displace	vt.取代，轉移
dispose	v. 處理，丟掉
disposition	n. 性情
disprove	v. 反駁，證明有誤
disreputable	adj.聲名狼藉的
disrespectful	adj. 無禮的，輕視的
disrupt	v. 使中斷，使分裂
dissect	v. 解剖，詳細研究
dissemble	v. 隱藏，偽裝
disseminate	v. 散步，傳播
dissimilar	adj. 不相似的，不同的
dissimulate	v. 假裝，掩飾
dissipate	v. 驅散，消散
distant	adj. 遠的
distillation	n. 蒸餾
distort	vt. 歪曲
distract	v. 分散，打擾
distressed	adj. 痛苦的
distribute	vt. 分發，分送，分佈
disunite	v. 使分離
diverge	vi. 分歧，差異
divergent	adj. 分歧的，分叉的
diverse	adj. 不同的
diversify	v. 使多樣化
divide	v. 分割，除
divulge	vt. 宣佈，洩露
doctrine	n. 教義，主義，學說
dodge	v. 躲開，逃避責任
dogma	n. 教義，教條
dogmatic	adj. 教條的，武斷的
doleful	adj. 悲哀的
dolphin	n. 海豚
domestic	adj. 家內的，國內的
dominant	adj. 佔優勢的，主導的
dominate	v. 統治，支配，控制
domineering	adj. 盛氣凌人的，專橫的
dominion	n. 領土，主權
donate	v. 捐贈
donor	n. 捐贈者
doom	v. 命定的，注定失敗的
dormant	adj. 休眠的
dormitory	n. 宿舍
doubt	v. n. 懷疑
doubtful	adj. 未確定的，不可靠的
downcast	adj. 沮喪的
down-hearted	adj. 情緒低落的
doze	v. 瞌睡
drag	v. 拖動
drastic	adj. 激烈的
drawback	n. 弊端，退款
dread	v. 畏懼，恐怖
drizzle	v. 下細雨
drought	n. 乾旱
drowsy	adj. 昏昏欲睡的
dual	adj. 二重的，兩層的
dubious	adj. 懷疑的
ductile	adj. 柔軟的，訓良的
due	adj. 預定的，應得的，到期的
dumb	adj. 啞的，無言的
dungeon	n. 地牢
durable	adj. 耐久的，持久的
dusky	adj. 微暗的，膚色黑的
dwell	vi. 居住
dwelling	n. 住所
dwindle	v. 減少
dye	n. 顏料，染色
eager	adj. 渴望的，熱心的
ebb	v. 退潮，衰退
eccentric	adj. 古怪的
economic	adj. 經濟的
economical	adj. 節約的，經濟的
economics	n. 經濟
economize	v. 節儉
ecstasy	n. 恍惚，狂喜
edge	n. 邊
edible	adj. 可食的
edify	v. 陶冶，教化
efface	v. 塗抹，消除
effect	n. 效果，印象
effective	adj. 有效的，有影響的
effectuate	v. 使實現
efficient	adj. 有效率的
effuse	v. 流出，散佈
egoist	n. 自我主義者
eject	v.  噴出，逐出
elaborate	adj. 精心製作，詳細闡述, 精心構思的
elapse	v. 消逝
elasticity	n. 彈性
elation	n. 得意洋洋
election	n. 選舉
elegant	adj. 雅致的
element	n. 元素
elementary	adj. 基本的，初級的
elevate	vt. 提高，抬高
elite	n.精華，中堅
eloquence	n. 雄辯
eloquent	adj. 雄辯的，有口才的
elucidate	vt. 闡明，說明
elude	v. 躲避，困惑
elusive	adj. 難懂得，躲避的
emaciate	v. 使瘦弱
emaciated	adj.瘦弱的，憔悴的
embalm	vt. 銘記，使不朽
embarrass	vt. 使困窘
embellish	v. 裝飾，修飾
embezzle	vt. 盜用
embody	vt. 體現，包含
embrace	vt. 擁抱，包含
embroider	vt. 繡花，裝飾
emend	vt. 修訂
emerge	vt. 出現
emigrate	vt. 移民
eminent	adj. 傑出的
emphasize	vt. 強調，著重
emphatic	adj. 顯著的，著重的，強調的
employee	n. 僱員
employer	n. 僱主，僱用者
empower	v. 授權，使能夠
empty	adj.  空的
emulate	v. 與競爭，倣傚
enable	vt. 使能夠
enact	vt. 制定，扮演
enchant	vt. 施魔法於
encompass	v. 包圍，環繞
encourage	vt. 鼓勵
encroach	vt. 蠶食，侵佔
encumber	v. 阻礙，妨礙
endanger	vt. 危害
endeavour	n. 努力
endless	adj. 無止境的
endorse	v. 確認。支持，贊同
endure	v. 忍受，容忍
energetic	adj. 積極的，精力旺盛的
energize	vt. 供給能量，使活躍
enervate	v. 使衰弱
engender	v. 產生
engross	vt. 全神貫注於
engrossed	adj. 全神貫注的
engulf	vt. 吞沒，吞食
enhance	vt. 增加
enigma	n. 謎
enigmatic	adj. 象謎一般的，難解的
enlighten	vt. 啟發，開導，啟蒙
enlist	vt. 徵召，招募
enormous	adj. 巨大的
enrage	vt.  激怒
enrapture	vt. 使狂喜，使出神
enrich	v. 豐富
enslave	v. 奴役
entail	v. 惹起，使負擔
entangle	vt. 使糾纏，使迷惑
enterprise	n. 事業，企業
entertain	vt. 招待，娛樂
enthral	v. 迷惑，使服從
enthusiasm	n. 熱情
entice	v. 誘惑
entitle	v. 題目為，給稱號，給於權力
entitle	v. 有資格的
entity	n. 實體
entrap	v. 以網或陷阱捕捉
entrepreneur	n. 企業家，主辦人
entry	n. 進入，入口，登記
enumerate	v. 枚舉，計數
enunciate	v. 闡明，清晰發音
envelop	vt. 包圍
envoy	n. 使者，公使
episode	n. 插曲
epoch	n. 紀元，時代
equal	adj. 相等的，同樣的
equate	vt. 使相等，視為同等
equation	n. 等式
equator	n. 赤道
equilibrium	n. 平衡狀態
equipment	n. 設備
equitable	adj. 公平的，公正的
equivalent	adj. 相等的，等同品
equivocate	vi. 說模稜兩可的話，支吾
equivocal	adj. 模稜兩可的，意義不清的
erase	v. 消除
erect	v. 建設，直立
erode	v. 蝕，腐蝕
erosion	n. 腐蝕
err	vt. 錯誤，犯錯
erratic	n. 古怪的，不穩定的
erroneous	adj. 錯誤的
erupt	vt. 爆發
escape	v. 避免，逃避
eschew	vt. 避開，遠離
escort	v. 護送
essential	adj. 重要的，基本的
esteem	n. 尊敬
estimable	adj. 可估計的
estimate	v. 估計
eternal	adj. 永恆的
ethics	n. 倫理學
ethnic	adj. 種族的
etiquette	n. 禮節
euphonious	adj. 悅耳的
evacuate	v. 疏散，使….空
evade	v. 逃避，迴避
evaluate	v. 評價，估價
evaporate	v. 蒸發
evasion	n. 逃避
evasive	adj. 逃避的，推委的
even	adj. 平的，偶數的
eventual	adj. 最後的
evidence	n. 證據，證人
evident	adj. 明白的
evoke	vt. 喚起
evolutionary	adj. 進化的
evolve	v. 使進化，使發展
exacting	adj. 費力的，嚴格的
exaggerate	v. 誇大，誇張
exalt	v. 稱讚，提升
exalted	adj. 尊貴的，興奮的
exasperate	v. 激怒
excavate	v. 挖掘
excellent	adj. 優秀的，傑出的
exception	n. 例外
exceptional	adj. 卓越的，例外的
excerpt	n.v.  摘錄
excess	n. 過度
excessive	adj. 過多的，極度的
exchange	vt.n. 兌換，交換，
excitement	n. 激動，興奮，刺激
exclaim	v. 呼喊，驚叫
exclude	v. 把….排除在外
exclusion	n. 除外，拒絕
exclusive	adj. 排外的，獨佔的
excuse	n. 借口
exemplary	adj. 模範的，典範的
exemplify	vt. 例證，例示
exempt	v. 免除，被免除的
exert	v. 發揮，施加
exhale	v. 呼出，發出，散發
exhaust	v. 使疲倦
exhaustive	adj. 五遺漏的，徹底的，廣泛的
exhibit	v. 顯示
exhume	vt. 掘出
exile	n. 流放，放逐，被流放者
exist	vi. 生存
exit	n. 出口，退出
exodus	n. 大批離去
exorbitant	adj. 過分的，過度的
exotic	adj. 外來的，有異國風味的
expansive	adj. 廣闊的，可擴張的，可膨脹的
expedient	adj. 權宜的，方便的
expedite	vt. 加速，派出，暢通
expedition	n. 遠征
expeditious	adj. 敏捷的，迅速的
experienced	adj. 有經驗的
expertise	n. 專門知識
expire	v. 失效，斷氣
explicit	adj. 明確的，清楚的
explode	vi. 爆炸
exploit	vt. 開發，剝削
explore	v. 探險，探索
explosive	adj. 爆炸的，炸藥
exponent	n. 解釋著，指數
exposure	n. 曝光
expound	v. 解釋
exquisite	adj. 精美的，靈敏的
extant	adj. 現存的
extemporaneous	adj. 即席的
extension	n. 延伸
extensive	adj. 大量的，廣泛的
extenuate	vt. 使…顯得輕微
exterminate	v. 消滅
external	adj. 外部的
extinct	adj. 熄滅的，滅絕的
extinction	n. 滅絕
extinguish	vt. 熄滅，消滅
extol	v. 頌揚
extort	v. 勒索，強索
extraneous	adj. 外來的，無關的
extravagant	adj. 奢侈的，浪費的
extricate	vt. 救出，使解脫
exude	v. 滲出，流出
exultant	adj. 歡騰的，狂歡的
eyewitness	n. 目擊者
fable	n. 寓言，傳說
fabricate	vt. 製造，偽造
facet	n. 方面，平面
facetious	adj. 幽默的，滑稽的
facile	adj. 輕而易舉的，隨和的
facility	n. 熟練，工具
factious	adj. 黨派的
faint	adj. 混暈的，模糊的，微弱的
faithful	adj. 忠實的。n. 信徒
fallible	adj. 易錯的
familiarize	v. 熟悉
famish	v. 使挨餓
fanatic	adj. 盲信者，狂熱的
fanaticism	n. 狂熱，盲從
fantasy	n. 幻想，空想，怪念頭
farce	n. 鬧劇
fascinate	v. 使迷惑
fashionable	adj. 流行的，時髦的
fatalism	n. 宿命論
fateful	adj. 重大的，預言性的，致命的，
fatuous	adj. 愚昧的
feasible	adj. 切實可行的
feat	n. 功績，壯舉
feeble	adj. 微弱的
feign	v. 假裝
fermentation	n. 發酵
ferocious	adj. 兇猛的
ferret	v. 搜索
fertile	adj.肥沃的，多產的
fertilizer	n. 肥料
fervent	adj. 白熱的，強烈的
fester	v. 化膿
fetter	n. 束縛
feud	n. 世仇，不和
feverish	adj. 發燒的
fickle	adj. 多變的
fiction	n. 小說
fictitious	adj. 虛構的
fidelity	n. 忠誠
figment	n. 虛構之事
figure-head	n. 名義領袖
filthy	adj. 污穢的，卑鄙的
final	adj. 最後的
finance	n. 財政，資助
finch	n. 鳴噙
fine	n. 罰金，細微的
firm	adj. 堅挺的，結實的
fishy	adj. 值得懷疑的
fit	vt. 適合的
fitful	adj. 一真真的，斷續的
fitting	adj. 適當的，配合
fixed	adj. 固定的
fixture	n. 固定設備
flare	n.v. 閃耀
flatter	vt. 奉承，阿諛，諂媚
flavour	n. 味，風味
flaw	n. 缺點
flay	vt. 剝皮
flee	v. 逃跑
flexible	adj.靈活的，變通的
flicker	v. 閃爍
flighty	adj. 輕浮的
flimsy	adj. 脆弱的，薄弱的
flip	v. 彈，投，翻滾
flora	n. 植物界
flounder	vi. 掙扎，躊躇
flout	v. 嘲弄
fluctuate	v. 波動，使波動
fluent	adj. 流利的，流暢的
fluffy	adj. 絨毛的
flush	v. 沖洗，臉紅
fluster	v. 使慌亂
foam	n. 泡沫
foe	n. 敵人
fog	n. 霧
foil	vt. 阻止
foment	v. 引發
forbid	v. 禁止
foremost	adj. 最初的，第一流的
forerunner	n. 先驅，祖先
foresee	vt. 預知
foresight	n. 預見，遠見
forestall	vt. 預先阻止
foretell	vt. 預言
forge	v. 鑄造，偽造
forlorn	adj. 掘網，被遺棄的
formal	adj. 正式的，禮儀上的
former	dj. 以前的
formidable	adj. 可畏懼的，可怕的
forsake	vt. 遺棄，拋棄，
fort	n. 要塞，堡壘
forte	n. 長處
forth	adv. 向前
forthright	adj. 直接的，立即的
fortify	v. 加強
fortitude	n. 堅韌，剛強
fortress	n. 堡壘，要塞
fortuitous	adj. 偶然的，意外的
fortunate	adj. 幸運的
fortune	n. 財富
foul	adj. 違規的，邪惡的
fowl	n. 雞，家禽
fraction	n. 片斷，分數
fracture	n. 斷裂，骨折
fragile	adj. 脆的，體制弱的
fragment	n. 碎片，破片
fragmentary	adj. 碎片的，不連續的
fragrant	adj. 香的，芬芳的
frail	adj. 脆弱的，意志薄弱的
frank	adj. 坦白的，直率的
fraternal	adj. 兄弟的，兄弟般的，友愛的
fraud	n. 欺騙
fraudulent	adj. 欺騙的，不誠實的
fraught	adj. 充滿的
frenzy	n. 狂熱
fret	v. 激怒
friction	n. 摩擦
fright	n. 驚嚇，恐怖
frigid	adj. 嚴寒的，冷淡的
frown	v. 皺眉，反對
frowzy	adj. 不整潔的，臭的
frugal	adj. 節約的
frustrate	v. 破壞，挫敗
fulminate	v. 猛烈爆發
functional	adj. 有用的
fund	n. 資金，基金，投資
fundamental	adj. 基礎的，基本的
furious	adj. 狂怒的，狂暴的
furniture	n. 傢俱
further	v. 促進，增進，更多的
fury	v. 勃然大怒
fusion	n. 融合，聯合
fussy	adj. 過分挑剔的
futile	adj. 無意的，徒勞的
fuzz	adj. 有絨毛的，絨毛狀的
gabble	vt. 急促而不清楚地說出
gainful	adj. 有利的，有報酬的
gainsay	v. 否認，反駁
galaxy	n. 星系，銀河
gale	n. 大風
gallant	adj. 英勇的
gallery	n. 畫廊
gangster	n. 暴徒，歹徒
gap	n. 裂口，差距
garb	n. 服裝，裝束
garner	v. 儲存
garnish	v. 加裝飾
gash	n. 深的切口
gasoline	n. 汽油
gasp	vt. 氣喘，喘息
gauche	adj. 笨拙的，粗魯的
gauge=gage	v. 精確計量
gaze	n. 凝視
gear	n. 齒輪
gem	n. 寶石
general	n. 普通的
generalize	v. 歸納，概括
generally	adv. 廣泛的，一般的
generate	vt. 造成
generous	adj. 慷慨的，大方的
generously	adv. 寬大的
genial	adj. 和藹的
genre	n. 題材，風格
genteel	adj. 上流社會的
gentility	n. 有教養，文雅
gentry	n. 貴族
genuine	adj. 真實的
geometry	n. 幾何學
germinate	v. 發芽
gibe	v. 譏笑
gild	v. 鍍金，虛事
girdle	n.帶，腰帶，帶狀物
gist	n. 要旨
glacial	adj. 冰河，冰川
glamour	n. 魅力
glamorous	adj. 富有魅力的
glaring	adj. 耀眼的，瞪眼的
glaze	v. 上釉使光滑，釉
gleam	v. 閃光，閃爍
glean	v. 收集
gleeful	adj. 及高興的，興奮的
glide	v. 滑動，溜走
gloom	n. 黑暗，憂愁
gloomy	adj. 暗的，憂鬱的
glorious	adj. 光榮的，壯麗的
glossary	n. 詞彙表
glossy	adj. 有光澤的
gnaw	v. 嚙，咬
gorge	n. 峽谷。 v. 塞飽
gorgeous	adj. 絢麗的，及好的
gossip	n. 閒話
govern	v. 決定，支配，控制
grab	v. 攫取，抓住
gracious	adj. 有禮貌的，仁慈的
grand	adj. 盛大的，壯麗的
grasp	v.n. 理解
grateful	adj. 感謝的
gratify	vt. 使滿意
gratitude	n. 感謝，感激
gratuitous	adj. 無理由的，不需要的
gravity	n. 引力
grease	n. 動物脂，脂肪
greasy	adj. 多脂的，油脂的
greedy	adj. 貪婪的
gregarious	adj. 群居的，合群的
grievance	n. 不滿
grieve	v. 悲傷
grieved	adj. 傷心的
grim	adj. 冷酷的，不吉祥的
grind	v. 折磨，壓搾
grip	v. 緊握
grope	v.n. 摸索
grotty	adj. 不悅的，慍怒的
grudge	n. 惡意
grumble	v. 喃喃訴苦
grumpy	adj. 壞脾氣的，性情暴躁的
guarantee	v. 確保
guileless	adj. 不狡猾的，誠實的
guise	n. 外觀，裝束
gush	v. 湧出
habituate	v. 習慣的
hackneyed	adj. 平凡的，陳腐的
haggle	v.n. 爭論
hail	n. 冰雹， v. 歡呼, 歡迎
halt	v. 停止，躊躇
hamper	v. 阻礙
handicap	v. 妨礙，使不利
handle	v. 操縱
handy	adj. 方便的，靈巧的
haphazard	adj. 偶然的，隨便的
harass	v. 侵擾
hardheaded	adj. 冷靜的，頑固的
hardly	adv. 幾乎不
hardy	adj.強壯的，耐勞的
harness	v. 利用
harry	v. 掠奪，折磨
harsh	adj. 嚴厲的，刺耳的
harvest	v.n. 收穫
hasten	v. 催促，趕緊
hasty	adj. 匆忙的
hatch	v. 孵出，孵卵
hatchet	n. 短柄斧
hatred	n. 憎惡，憎恨
haughty	adj. 傲慢的，輕蔑的
haul	v. 拖曳，拖運
haunt	v. 縈繞於心，常到
haven	n. 避難所
hazard	v. 危險，公害
hazardous	adj. 危險的
head	n.頭，v.向某處走去
headstrong	adj. 頑固的
heal 	v. 治癒，使和解，痊癒
healthful	adj. 有益健康的
hearsay	n. 謠傳，風聞
heave	v. 用力舉起，托
hectic	adj. 忙碌的，發熱的
heedless	adj. 不留心的
heirship	n. 繼承權
helpless	adj. 無助的
heredity	n. 遺傳
heresy	n. 異端，斜說
heritage	n. 遺產
hermit	n. 隱居者
hesitate	v.猶豫，躊躇，含糊
hew	v. 砍，伐，削
hideous	adj. 駭人聽聞的，醜惡的
highlight	v. 突出顯示，強調
hike	n. 上升
hilarious	adj. 高興的，熱鬧的
hilarity	n. 歡鬧
hinder	v. 妨礙
hinge	v. 依…而定
hinge	n. 鉸鏈
hoarse	adj. 嘶啞的
hoax	v.n. 愚弄
hoist	n. 升起，吊車
holocaust	n. 大屠殺
homage	n. 敬意
homicide	n. 殺人
homogeneous	adj. 同類的，相似的
horizontal	adj.水平的
horror	n. 恐懼
hospitable	adj. 好客的
hostile	adj. 敵對的，不友好的
howl	v.n. 嚎叫
hubbub	n. 嘈雜
human	adj. 人類的，人性的
humane	adj. 仁慈的，親切的
humid	adj. 潮濕的
humidity	n. 潮濕
humiliate	v. 屈辱，貶義
humorous	adj. 幽默的
hump	n. 駝峰，v.隆起
hunger	n. 飢餓，渴望
hurdle	n. 籬笆，障礙
hurl	v. 孟投，猛衝
hurricane	n. 颶風
husbandry	n. 耕種，管理
hustle	v. 驅趕
hybrid	n. 雜種，混血兒
hygiene	n. 衛生
hypothesis	n. 假設
iceberg	n. 冰山
identical	adj. 同一的
identify	v. 認出
ideology	n. 意識形態
idiocy	n. 白癡
idiosyncrasy	n. 個人特性
idiot	n. 白癡，傻子
idiotic	adj. 愚蠢的
idol	n. 偶像
idyllic	adj. 田園詩的
ignite	v. 使…燃著
ignoble	adj. 卑微的
ignominious	adj. 可恥的，不名譽的
ignorance	n. 無知
ignorant	adj. 無知的，不瞭解的
ignore	vt. 忽視
illegible	adj. 難辨認的
illegitimate	adj. 非法的，私生的
illicit	adj. 違法的
illiterate	n. 文盲
illuminate	vt. 照亮，照明，說明
illusion	n. 幻覺
illustrate	v. 說明
illustrious	adj. 輝煌的，著名的
imaginary	adj. 虛構的
imaginative	adj. 富於想像的
imbibe	v. 飲
imbue	v. 浸染，灌輸
imitate	v. 模仿
immediate	adj. 立即的
immense	adj. 巨大的，無限的
immerse	vt. 沉浸，給…施洗禮
immigrate	v. 移居入境
imminent	adj. 即將來臨的
immobile	adj . 固定的
immortal	adj. 不朽的
immune	adj. 免除的，免疫的
impact	v. 影響，作用，衝擊
impair	v. 損害
impale	v. 刺穿，刺住
impart	v. 給予，傳遞，告訴
impartial	adj. 公正的，無偏見的
impassioned	adj. 熱烈的
impassive	adj. 無感情的
impatient	adj. 不耐煩的
impeach	vt. 控告，彈劾
impeccable	adj. 無暇的
impel	v. 驅使
imperative	adj. 急需的，命令的
impertinent	adj. 無關的
impervious	adj. 不能滲透的
impetuous	adj. 猛烈的，衝動的
impetus	n. 推動力
implement	v. 實現
implement	n. 工具
implicate	v. 牽連
implicit	adj. 暗示的，含蓄的
imposing	adj. 令人難忘的
impotence	n. 無效，無力，虛弱
impressionism	n. 印象派
impressively	adv. 令人難忘的
imprisonment	n. 監禁
impromptu	adj. 臨時的，即興的
impropriety	n. 不適當
improvident	adj. 浪費的
improvise	v. 即席而作
imprudent	adj. 輕率的，不謹慎的
impudent	adj. 魯莽的
impulse	n. 衝動，刺激，推動
impulsive	adj. 易衝動的,任性的
impunity	n. 免罰
impure	adj. 髒的，不純潔的
impurity	n.雜質
impute	v. 歸咎於
inaugurate	v. 開始，使…就職
inborn	adj. 天生的
incapacitate	v. 使不能
incense	v. 激怒
incentive	n. 刺激，動機
incessant	adj. 不斷的
incipient	adj. 初期的
incisive	adj. 尖銳的，深刻的
incite	v. 引起，激動，煽動
inclined	adj. 傾向的
incoherent	adj. 不連貫的
incompatible	adj. 不兼容的
incompetent	adj. 不稱職的
inconceivable	adj. 不可思議的
incongruity	n. 不和諧
incongruous	adj. 不協調的
incorruptible	adj. 廉潔的
incredible	adj. 難以相信的
incredulity	n. 懷疑
incriminate	v. 控告，使負罪
incur	v. 遭遇，遭致，承擔
indecent	adj. 無理的，下流的
indefatigable	adj. 不疲倦的
indefinite	adj. 不明確的，不定的
indemnity	n. 賠償
indent	n. 縮排，縮進，契約
indicate	vt.指示，表示
indictment	n. 起訴
indifferent	adj. 冷漠的，不積極的
indigenous	adj. 土產的，固有的
indigent	adj. 貧窮的
indignant	adj. 憤慨的，義憤的
indignity	n. 侮辱
indolent	adj. 懶惰的
indomitable	adj. 不屈不撓的
induce	v. 導致，誘使
industrial	adj. 工業的
industrious	adj. 勤勉的
ineligible	adj. 無資格的，不適當的
inept	adj. 不適宜的
inert	adj. 不活潑的，遲鈍的
inertial	adj. 慣性
inevitable	adj. 不可避免的，必然的
infallible	adj. 必然的，不會錯的
infamous	adj. 臭名昭著的
infect	v. 傳染，感染
infectious	adj. 傳染的，感染性的
infer	v. 推知
inferior	adj. 下級，晚輩，次品，劣等的，自備的
inflation	n. 通貨膨脹
inflexible	adj. 堅定的
inflict	v. 造成
influential	adj. 有影響的，有權勢的
influx	n. 流入，灌輸
informal	adj. 不拘禮節的，隨便的
infringe	v. 侵犯，違反
infuse	vt. 灌輸，浸漬
ingenious	adj. 機靈的，精巧製成的
inhabit	vt. 居住於，棲息於
inhabitant	n. 居民，住戶
inherent	adj. 固有的
initial	adj. 初始的
initiate	v. 開始，初始，啟蒙
inject	v. 注射，注入
injure	v. 傷害，損害，損傷
injurious	adj. 侮辱，損害的，誹謗的
innate	adj. 天生的
innocent	adj. 清白的，幼稚的
innovation	n. 改革，革新
innumerable	adj. 無數的
inordinate	adj. 無節制的，過度的
inquiry	n. 調查，研究
inquisitive	adj. 好奇的
insane	adj. 發狂，精神錯亂的
insert	v. 插入
insinuate	v. 迂迴進入，暗示
insist	v. 主張，堅持說
insolent	adj. 傲慢的，無理的
inspect	v. 檢查，視察
install	v. 安裝，設置
instantaneous	adj. 瞬間的，即可的
instigate	v. 鼓動
instill	v. 灌輸
instinctive	adj. 天生的，本能的
institute	v. 建立， n. 研究所
instruct	v. 教，命令
instrument	n. 儀器，工具，樂器
instrumental	adj. 有幫助的，儀器的，機械的
insubordinate	adj. 不服從得
insufferable	adj. 難以忍受的
insular	adj. 海島的，狹隘的
insult	v.n. 侮辱，凌辱
integral	adj. 組成的，整的
integrate	v. 使結合，使進入
integrity	n. 正值，完整性
intellectual	adj. 智力的
intelligence	n. 智力
intelligent	adj. 聰明的
intelligible	adj. 可理解的
intense	adj. 非常的，緊張的
intensify	v. 加強
intensive	adj. 集中的
intercede	v.調停，調解
intercept	v. 中途攔截，阻止
interest	n. 興趣，利息
interfere	v.  干涉，干預，妨礙
interior	adj. 內部
interject	v. 突然插入
interlude	n. 間隔，插曲
intermediary	n. 媒介物，居間者
intermediate	adj. 中級的
internal	adj. 內在的
interrogate	v. 審問，詢問
interrupt	v. 打斷，插嘴
intersect	v. 相交
intervene	v. 干涉
intimacy	n. 熟悉，親近
intimate	adj. 親密的，v. 暗示
intimidate	v. 恐嚇
intoxicate	vt. 使陶醉，使中毒
intrepid	adj. 勇敢的
intricate	adj. 錯綜複雜的，難懂的
intrinsic	adj. 本質的，本身的
intrude	v. 侵擾
intuition	n. 直覺
inure	v. 使習慣
invade	v. 侵入，侵犯
invalid	adj. 無效的，有病的
invalidate	vt. 使作廢
invaluable	adj. 無價的
inventory	n. 物品清單，庫存物品
inverse	n. 反的
invert	v. 倒轉
investigate	v. 調查，研究
inviting	adj. 誘人的，引人注目的
invocation	n. 祈禱
invoke	v. 懇求，祈求
irreconcilable	adj. 不能妥協的
irrelevant	adj. 離題的，無關的
irrepressible	adj. 不可壓制的，難以征服的
irreproachable	adj. 無可指責的
irresistible	adj. 不可抗拒的
irresolute	adj. 猶豫不決的
irreverent	adj. 不恭敬的
irrevocable	adj. 不能取消的
irrigate	vt. 灌溉
irritable	adj. 過敏的，易怒的
irritate	v. 激怒
isolate	v. 使隔離
issue	n. 問題，出版，發行, 期， v. 發行
itinerant	adj. 巡迴的，流動的
jar	n.v.adj. 震動
jealous	adj. 妒忌的，猜疑的
jeer	n.v. 嘲笑
jellyfish	n. 水母
jeopardy	n. 危險
jerk	v. 急拉，抽搐
jolt	v.n. 搖動
joyous	adj. 快樂的，高興的
judgement	n. 判決
jumble	v. 混雜
junction	n. 連接，匯合處
juncture	n. 接合點
jurisdiction	n. 司法權
justify	v. 證明…是正當的
justly	adv. 公正的
juvenile	adj. 青少年的
ken	n. 視野，知識
kidnap	vt. 綁架
kindle	v. 燃起，激起
kingdom	n. 王國
knowledgeable	adj. 有見識的
laborious	adj. 勤勞的，費力的，艱難的
labyrinth	n. 迷宮，錯綜複雜之事件
lag	n. 落後
lament	n. 悲傷，痛惜
land	v. 著陸，降落
languid	adj. 精神不振的
languish	v. 變衰弱
lash	v. 鞭打
lasting	adj. 持久
lately	adv. 最近
latitude	n. 緯度
laud	v.n. 讚美
laudable	adj. 值得讚美的
launch	v. 發射，透射，發動，使…升空
laurel	n. 月桂樹
lavish	adj. 豐富的，浪費的
lawn	n. 草地，草坪，操場
lawsuit	n. 訴訟
lead	v. 引導，n. 鉛
leading	adj. 指導的，最主要的
league	n. 同盟，聯盟，聯合會
leak	n. v. 洩漏
lease	v. 出租
leash	n. 牽狗的皮帶，束縛
ledge	n. 壁架，突出物，暗礁
legacy	n. 遺產，遺物
legalize	v. 合法化，法律認可
legendary	adj. 傳奇的
legislate	v. 立法
lethal	adj. 致命的
levy	n. v. 課稅，徵收
liaison	n. 聯絡
liberal	adj. 心胸寬大的，慷慨的
liberate	v. 釋放
licenced	adj. 被許可的
limestone	n. 石灰石
limp	v. 蹣跚，瘸著走
limpid	adj. 清澈的
linguistics	n. 語言學
liquid	n. 液體
listless	adj. 冷漠的，不留心的
literate	adj. 有文化的，能讀寫的
lithe	adj. （指人、身體）柔軟的，易彎的
loan	v. 借， 貸款
loath	dj. 不喜歡的
loathe	v. 厭惡
locate	v. 找出，設置
lofty	adj. 高聳的，高尚的
log	n. 原木，日誌
logical	adj. 合邏輯的
long	v. 渴望
longitude	n. 經度
loop	n. 圈，環，環孔
loose	adj. 寬鬆的
loot	v. 掠奪
lottery	n. 獎券，抽獎，碰巧之事
lown	adj. 歇息，使平靜
luminous	adj. 發光的, 明亮的
lure	v. 誘惑
lurk	v. 躲藏
luster	n.v. 光彩，光澤
lusty	adj. 強壯的，有精神的
luxuriant	adj. 繁茂的，多產的
luxurious	adj. 奢侈的
lyric	n. 抒情詩，歌詞
magnificent	adj. 壯麗的，華麗的
maim	v. 使殘廢，損傷
maintain	v. 堅持認為，維修
major	adj. 專業，主要的
majority	n. 多數，大多數
malady	n. 疾病
malcontent	n. 不平者，不滿者
malevolent	adj. 惡意的
malice	n. 惡意
malicious	adj. 心毒的，懷惡意的
malign	v. 詆毀，誹謗
malleable	adj. 有延展性的，可鍛的
mammal	n. 哺乳動物
mandate	n. 命令，要求
mandatory	adj. 命令的，強制的
manoeuvre	v. 調遣，策略
mangle	v. 撕裂，毀壞
mania	n. 癲狂，狂熱
manifold	adj. 多方面的，多樣的
manipulate	v. 操作
manufacture	v. 製造，製造產品
manure	v. 施肥
marble	n. 大理石
margin	n. 頁邊的空白，欄外
marine	adj. 海的，海上的
marital	adj. 婚姻的
maritime	adj. 海上的，近海的
marvelous	adj.  不可思議的, 了不起的
mass	n. 質量
massive	adj. 巨大的
massless	adj. 無以論比的
mathematics	n. 數學
maxim	n. 格言，箴言
maze	n. 迷惑，迷宮
mean	v. 意預，卑鄙的
meander	v. 蜿蜒而流
means	n. 手段，方法，錢
mechanical	adj. 機械的
mechanics	n. 力學
meddle	v. 干預
mediate	v. 調停
mediocre	adj. 平常的，普通的
meditate	v. 深思的
medium	adj. 媒介，中間，中等的
meek	adj. 溫順的，柔和的
menace	n. 威脅，脅迫
mend	v. 改進，修正，改正
menial	adj. 奴僕的，卑賤的
mention	v.n. 主張，提及
merchandise	n. 商品
merciful	adj. 仁慈的，寬大的
merge	v. 合併
merit	n. 優點
messy	adj. 骯髒的，凌亂的
metabolism	n. 新陳代謝
methodical	adj. 有條理的
meticulously	adj. 很仔細的
mighty	adj. 巨大的
mimicry	n. 模仿，擬態
mine	v. 採礦
minority	n. 少數，少數民族
minute	adj. 微小的
miser	n. 守財奴，吝嗇鬼
miserable	adj. 痛苦的，可憐的
miserly	adj. 吝嗇的
misery	n. 痛苦，苦惱
misgiving	n.疑懼，疑慮
mishap	n. 災禍，不幸
mitigate	v. 緩和，減輕
mock	v.n. 嘲弄，挖苦
moderate	adj. 溫和的，有節制的
modest	adj. 謙虛的，適度的
modify	v. 修改
modulate	vt. 調整
moist	adj. 濕潤的， 多雨的
moisten	v. 使濕潤
mold=mould	v. 塑造
molecule	n. 分子
mollify	v.緩和
momentous	adj. 極重要的
monarch	n.君主，最高統治者
monitor	n.v. 監視器，監控
monotonous	adj. 單調的
monster	n. 怪物，巨獸
morale	n. 民心，士氣
morbid	adj. 病態的，不健康的
moron	n. 低能兒，白癡
mortal	n. 凡人，adj. 終有一死的
mostly	adv. 多半的，通常
motif	n. 主題，主旨
motion	v.n. 運動
motivation	n. 動機
muddle	v. 使混亂
multitude	n. 眾多
munificent	adj. 慷慨的
mutation	n. 變化
mutual	adj. 相互的，共同的
mysterious	adj, 神秘的，難以理解的
narrate	v. 敘述
nationality	n. 國籍
natural	adj. 自然的
naughty	adj. 頑皮的，淘氣的
naval	adj. 海軍的
navigation	n. 航海
nearly	adv. 幾乎
needy	adj. 貧窮的
neglect	vt.n. 疏忽，忘記
negligence	n. 過失，疏忽
negligent	adj. 忽略的
negotiate	v. 談判，交涉，議定
nervous	adj. 神經的，易激動的
neutral	adj. 中性的，中立的
neutralize	v. 中合，壓制
nibble	v. 細咬，細食
nimble	adj. 輕快的。靈敏的
nocturnal	adj. 夜間的
nod	v. 點頭，首肯
nominate	vt. 任命
nonsense	n. 胡說，廢話
nostalgia	n. 思鄉，懷舊
notable	adj. 著名的，顯要的
noted	adj. 著名的，知名的
notorious	adj. 臭名昭著的
novelty	n. 新穎，新奇的事物
novice	n. 新信徒，新手
noxious	adj. 有害的，有毒的
nuclear	adj. 原子的
null	adj. 無效的，空的
numb	adj.n. 麻木的
numerous	adj. 眾多的
nurture	n.v. 養育
nutriment	n. 營養品
oasis	n. 綠洲
oath	n. 誓言，誓約，宣誓
obedience	n. 服從，順從
objective	n. 目標，adj. 客觀的
obligatory	adj. 義務的，必需的
obliging	adj. 好施恩的，願幫助的
oblivion	n. 忘卻，遺忘
obscene	adj. 猥褻的
obscure	adj. 模糊的，無名氣的
obscure	v. 掩蓋
observance	n. 遵守
observation	n. 觀察
observe	v. 看到，遵守
obsolete	adj. 過時的
obstacle	n. 障礙
obstinate	adj. 固執的
obstruct	v. 阻礙，妨礙
obtain	vt. 得到
obvious	adj. 明顯的
occasional	adj. 偶然的，臨時的
odor=odour	n. 臭氣，名聲
offensive	adj.  無理的， 攻擊性的
offer	n.v. 提議，提出
offhand	adj. 臨時的，無準備的
offspring	n. 子孫，後代
omit	v. 省略，省去，遺漏
onset	n. 攻擊，開始
opera	n. 歌劇
operate	v. 操縱
operator	n. 接線員
opponent	n. 敵人，對手
opportunity	n. 機會
opposed	adj. 反對的
optimum	adj. 最優的
option	n. 選擇，取捨
opulence	n. 財富，富裕
oracle	n. 神諭
oration	n. 演說
orator	n. 演講者
orbit	n. 軌道
orchestra	n. 管絃樂隊
ordeal	n. 嚴酷的考驗
ore	n. 礦石
organism	n. 生物，有機物
original	adj. 最初的，獨創的
originally	adv. 本來，最初
originate	v. 發起
ornament	n. 裝飾物，裝修
oust	v. 驅逐
outcome	n. 後果，成果
outfit	n. 服裝，裝備，用具
outing	n. 郊遊，遠足
output	n. 產量，輸出量
outrage	v. 激怒，侵犯
outrageous	adj. 暴亂的
outspoken	adj. 坦率直言的
outstanding	adj. 顯著的，傑出的
outwit	v. 哄騙
overbearing	adj. 傲慢的
overdue	adj. 逾期
overflow	n.v. 溢出
overlook	v.忽略，疏忽
oxygen	n. 氧氣
pacify	v. 鎮定，撫慰
pact	n. 協定
painstaking	n.adj. 辛勞，勞苦的
palatable	adj. 味美的
pamphlet	n. 小冊子
panacea	n. 萬靈藥
panic	n. 恐慌
parade	n.v. 遊行
parallel	v. 與…平行， 匹敵，平行的
paraphrase	v. 意譯， 改寫
parasite	n. 寄生蟲，寄生植物
parasitic	adj. 寄生的
partial	adj. 部分，偏袒的
partially	adv. 部分的，不公平的
particle	n. 微粒，顆粒
partisan	adj. 黨派的，派系感強的
party	n. 團體，一夥
passionate	adj. 易怒的，多情的，熱情的
patronage	n. 贊助，資助
peak	n. 高峰，尖端
peck	v. 啄，啄起
peerless	adj. 無一輪比的
penal	adj. 受刑法的，刑事的
penchant	n. 傾向，愛好
pending	adj. 未決的
penetrate	v. 刺穿，進入
peninsula	n. 半島
pensive	adj. 憂愁的，哀思的
penury	n. 貧窮
perceive	v. 察覺到，看見
perceptive	adj. 知覺的
percussion	n. 打擊樂器，震盪
perennial	adj. 長久的，永遠的
perfect	adj. 無暇的，完好無損的
peril	n. 危機，危險的事物
perilous	adj. 危險的
permanent	adj. 永久的
permeate	v. 滲透，透過
permissible	adj. 可容許的
permissive	adj. 許可的
permit	v. 准許
perpetuate	v. 使永恆，使延續
perplex	v. 迷惑，困惑，難住
persevere	v. 堅持，不屈不撓
persistent	adj. 堅持不懈的
personnel	n. 人員，職員
perspective	n. 頭時，遠景，觀點
persuasive	adj. 有說服力的
pertinent	adj. 適當的，切題的
pervade	v. 遍佈，瀰漫
pervert	v. 倒入斜途，曲解
petition	v. 請願，向…請願
petrify	v. 變為化石，使發呆
phase	n. 階段，態
phonetics	n. 語音學
picturesque	adj. 如畫般的，生動的
pierce	v. 穿透，戳穿，洞察
pilferage	n. 偷竊
pious	adj. 虔誠的
pit	n. 坑，地坑，煤礦
pitiful	adj. 慈悲的，可憐的
pivot	n. 軸，關鍵，轉折點
pivotal	adj. 樞紐的，關鍵的
placate	v. 安撫，和解
placid	adj. 安靜的
plague	v. 使苦惱,疫病，災禍
plaintiff	n. 原告
planet	n. 行星
plateau	n. 高原
plausible	adj. 似合理的
playwright	n. 劇作家
plea	n. 懇求
plead	v. 侃辨，懇求
pleasing	adj. 愉快的
pleasure	n. 快樂
pledge	n.v. 誓言，使發誓
plight	n. 情勢，困境
plot	v. 密謀策劃
plumb	adj. 垂直的
plunge	v. 投入
poise	v. 猶豫，平衡，穩定
pollute	v. 污染
ponder	v. 考慮，沉思
ponderous	adj. 沉重的，笨重的
portable	adj. 可攜帶的
portion	n. 一部分
portrait	n. 小巷，畫像，描寫
portray	v. 繪製
pose	v. 構成，擺好姿勢
positive	adj. 積極的
posterity	n. 後代
postpone	v. 延隔
posture	n. 人體的姿勢
potent	adj. 強有力的，有全權的
potential	adj. 可能的，潛在的
poultry	n. 家禽
practical	adj. 實踐的，適用的
preach	v. 說教，布道，鼓吹
precede	v. 先於，領先
precious	adj. 寶貴的，珍貴的
precipitate	v. 降水，加速
precise	adj. 周密的，精確的
preclude	n. 排出，防止
precursor	n. 先兆，先驅
predominate	v. 佔優勢，支配
preeminent	adj. 卓越的
preferable	adj. 更好的，可取的
preference	n. 偏愛，有限，優先權
pregnant	adj. 懷孕的，孕育的
prelude	n. 序幕
premise	v. 提出前提，前提
prescription	n. 指示，藥方
preserve	v. 保存
pressure	n. 壓力，壓迫
prestige	n. 威望，聲望
presume	v. 假定，假設
presumption	n. 推定，猜想
presumptuous	adj. 專橫的
pretend	vt. 偽裝，裝腔
pretentious	adj. 裝腔作勢的
prevail	v. 流行，盛行
prevalent	adj. 普遍的，流行的
prevent	v. 阻礙
previous	adj. 以前的
primary	adj. 最初的，重要的
primitive	adj. 原始的，最初的
principal	n. 校長，adj. 重要的
privilege	n. 特權
probe	v. 探查
probity	n. 正直
proceed	v. 進行
process	n. 過程，處理
proclaim	v. 宣佈，聲明
prod	v. 刺激
prodigal	adj. 浪費的
prodigious	adj. 巨大的
profane	v. 褻瀆
profess	v. 表明
profile	n. 外表，輪廓
profoundly	adv. 深刻的，深度的
profuse	adj. 極其豐富的
progress	n. 前進，發展
proliferate	v. 繁衍
prolific	adj. 多產的
prolong	vt. 拖長，延長
prominent	adj. 卓越的，突出的
promising	adj. 有前途的，有希望的
promote	v. 促進，升職
prompt	v. 迅速的，鼓動
prone	adj. 傾向於
pronounced	adj. 明顯的
prop	v. 支持
propagate	v. 繁衍，宣傳
propel	v. 推進，促進
propensity	n. 傾向
proportion	n.比例，部分
proposal	n. 提案，建議
propose	v. 提出，提議
propriety	n. 適當
proscribe	v. 禁止
prosecute	v.起訴，檢舉
prospect	n. 前景，期望
prospective	adj. 預期的
prosperous	adj. 繁榮的
prosperity	n. 繁榮
protein	n. 蛋白質
protract	v. 延長
protrude	v. 突出
provide	v. 提供
provident	adj. 有遠見的
provision	n. 供應
provoke	vt. 激怒，煽動
proximity	n. 臨近，親近
proxy	n. 代理人
prudent	adj.謹慎的
prune	v. 檢修
puddle	n. 小水窪
punch	v.重擊，打孔
punctual	adj. 守時的
pungent	adj. 辛辣的
purchase	v.n. 購買
purge	v. 消除，洗滌
quaint	adj. 奇異的，不凡的
qualified	adj. 合格的
quality	n. 品質
quantitative	adj. 定量的
quarter	n. 四分之一
quartz	n. 石英
queer	adj. 奇怪的，古怪的
quell	v. 壓制
query	n. 質問，問題, 詢問
quiver	n. 震動
quota	n. 限額，定額
radiant	adj. 絢麗的，容光煥發的
radiate	v. 射出
radical	adj. 根本的，激進的
radius	n. 半徑
rage	n. 激怒，憤怒
ragged	adj. 襤褸的，破爛的
raid	n.v. 襲擊
raise	n. 養殖，募捐
rally	v. 召集，恢復
rank	n. 等級，排序, 排行
ransom	v. 贖金，賠償金
rap	v. 責難，敲擊
rapacious	adj. 貪婪的，強奪的
rapture	v. 狂喜
rashly	adv. 魯莽的
ratify	v. 批准
ratio	n. 比率
ration	n. 定量，配給量
rational	adj. 合理的
ravage	v. 掠奪，破壞
ravenous	adj. 極餓的，貪婪的
ravish	v. 搶奪，使…狂喜
ray	n. 光線
raze	v. 摧毀
readily	adv. 願意的，容易的
realize	v. 實現, 認識到
realm	n. 王國，領域
reason	n. 原因，推論
rebate	n. 返回款，折扣
rebel	n. 謀反，叛徒著
rebellion	v. 造反，叛亂，反抗
rebuke	n.v. 斥責
recall	v. 憶起，記憶
recently	adv. 最近的
reception	n. 接待，招待會，接受
recipient	n. 接受著
reciprocal	adj. 相互的，交往的
reckless	adj. 魯莽的
recluse	n. 隱士
recognition	n. 認識，承認
recognize	v. 認識，認出，承認
recoil	n. 後退，退縮
recollection	n. 記起，回想
recommend	v. 勸告，推薦
reconcile	v. 和解
reconciliation	n. 和解
recover	v. 恢復
recreation	n. 消遣
recruit	v. 徵兵，徵募
rectangle	n. 長方形
redeem	v. 取回，贖回
redress	v. 救濟，補償
reduce	v. 減少，簡化
redundant	adj. 過多的，冗長的
refer	v. 延及，提到
refined	adj. 精緻的， 文雅的
reflection	n. 反映
reform	v. 改革，革新
refresh	v. 使清新，恢復精神
refuge	n. 避難所
refund	v. 退還，償還
refute	v. 駁斥，反駁，駁倒
regimen	n. 政權，養生法
register	v.n.登記
rehabilitate	v. 恢復
rehearse	v. 預演，排練
reign	v.n. 統治
reimburse	v. 償還
reinforce	v. 加強，加固
reiterate	v. 重訴
reject	v. 拋棄，拒收
relapse	v. 復發，回復
relax	v. 鬆弛，放鬆
relentless	adj. 無情的
relevant	adj. 有關的，貼切的
reliable	adj. 可靠的，可信賴的
relieved	adj. 放心的，免除的
religion	n. 宗教
relinquish	v. 放棄
reluctant	adj. 不情願的，勉強的
remarkable	adj. 值得注意的
remedy	n. 治療法，藥物, 治療
remind	v. 提醒
remit	v. 匯寄，赦免
remnant	n. 殘餘，遺跡
remote	adj. 遙遠的，遠程的
remove	v. 移動，搬開，脫掉
renaissance	n. 文藝復興
rend	v. 分離，撕破
render	v. 提供，表達
renounce	v. 放棄，否認
renovate	v. 革新
renowned	adj. 知名的
repel	v. 排斥
replenish	v. 補充
reproach	v. 責備
reproduction	n. 繁殖，複製品
repudiate	v. 批判
repulse	v.n. 排斥，擊退
repulsive	adj. 排斥的
rescue	v.n. 拯救
resemble	v. 象，類似
resent	v. 憎恨
reside	v. 居住
resident	adj. 居住的，常駐的
residue	n. 殘餘
resist	v. 抵抗，堅持
resolute	adj. 堅決的
resolve	n.v. 決定
resolved	adj. 下定決心的
resonance	n. 回聲，反響
respective	adj. 分別的， 各自的
respiration	n. 呼吸
responsible	adj. 有責任的
restore	v. 恢復
restrain	v. 限制
restrict	v. 限制
resume	v. 繼續
retain	v. 保留
retard	vt. 延遲
retort	v. 反駁
retract	v. 縮回，撤回
retrieve	v. 重新找回
reveal	v. 展現，揭露
revelation	n. 顯示，揭露
revenue	n. 收入
revere	v. 尊敬
reverence	n.v. 尊敬
revert	v. 回復
revise	v. 修訂
revive	v. 復活
revoke	v. 取消，撤回
riddle	n. 謎
ridiculous	adj. 荒謬的
rigid	adj. 嚴格的，僵化的
rigor	n. 嚴格，嚴厲
rigorous	adj. 嚴厲的，嚴峻的
rim	n. 邊緣
riot	n. 暴亂，騷動
ripe	adj. 成熟的
risk	v.n. 冒險
rite	n. 宗教儀式
rival	v. 競爭，匹敵， 對手
robust	adj. 強壯的
role	n. 角色，任務
roll	v. 滾動
rot	v. 腐爛
rotten	adj. 腐爛的
rough	adj. 大致的，不平的，粗暴的
routine	n. 常規的
rubbish	n. 垃圾
rudimentary	adj. 根本的，低級的
rugged	adj. 粗糙的，不平的
rumble	v. 隆隆行駛，低沉的說
ruminate	v. 沉思
rupture	v.n. 破裂，決裂
rust	v. 生蛂A氧化
rustic	adj. 鄉村的，粗俗的
ruthless	adj. 無情的，冷酷的
sacred	adj. 上帝的，神聖的
saddle	v. 使…負擔
sake	n. 緣故，原因
salvage	v. 救護，搶救
sample	n. 範例，樣品
sane	adj. 理智的，健全的
sanity	n. 神志清楚的
sarcasm	n. 諷刺，挖苦
sarcastic	adj. 諷刺的，挖苦的
sardonic	adj. 諷刺的，嘲笑的
satiate	v. 使..飽享，使..滿足
satire	n. 諷刺文學
satirical	adj. 諷刺的
satisfactory	adj. 令人滿意的
saturate	v. 浸透
save	v. 除了… ， 拯救
savings	n. 儲蓄
savor	n. 嘗味
scale	v. 攀登，規模，尺度，稱，鱗片
scan	v. 劉瀾，掃瞄
scandal	n. 醜聞
scanty	adj. 貧乏的
scarce	adj. 缺乏的，不足的
scare	v.n. 驚嚇，使受驚
scatter	v. 分散
scenery	n. 景色
schedule	n. 時間表，計劃表
scholarship	n. 獎學金
scoop	v. 汲取，挖掘，勺子
scope	n. 範圍，餘地
scorch	v.n. 烤焦，使褪色
scornful	adj. 輕蔑的
scout	n. 巡邏，偵察員，童子軍
scrap	n. 廢料，碎片，廢棄
scratch	n. 刮擦，劃痕
screen	n. 屏幕，遮蔽
scruple	v. 躊躇，顧及
scrupulous	adj. 嚴謹的，講究的
scrutinize	v. 細查
sculpture	n. 雕塑品
sear	v. 燒灼
seasoning	n. 調味品, 作料
seclusion	n. 歸隱，隔離
secrete	v. 分泌
secretion	n. 分泌
sedate	adj. 安靜的
sediment	n. 沉積物，沉澱物
seemingly	adv. 表面上，似乎
segment	n. 部分，片斷
segregate	v. 隔離，分離
seize	v. 奪取， 捕獲
selection	n. 選擇
selfish	adj. 自私的
semester	n. 學期
sensible	adj. 理智的，明顯的，感覺到的
sensitive	adj. 敏感的
sensuous	adj. 感覺的，美感的
sentimental	adj. 傷感的，多愁善感的
sequence	n. 序列
serene	adj. 晴朗的，平靜的
serenity	n. 安靜，從容
serious	adj. 嚴肅的，認真的
sermon	n. 說教
session	n. 會議，一段時間一次
sever	v. 分開，斷絕
severe	adj. 嚴重的，嚴肅的
shabby	adj. 襤褸的，破舊的
shackle	v. 加桎枯，束縛
shade	n. 差別
shaft	n. 軸，柄
shake	v.n. 搖，震動
sallow	adj. 淺的
shameless	adj. 無恥的
sharpen	v. 削尖，使敏銳
shatter	n. 碎片，v. 使粉碎，破碎
shear	v. 修剪
sheathe	v. 入鞘
sheer	 adj. 純粹的，全然的
shield	v. 癖護，保護
shipment	n. 裝船，出貨
shove	v. 推擠
shrewd	adj. 精明的
shrink	v. 收縮
shuffle	v. 攪亂，混合
shun	v. 避開
shy	adj. 害羞的，膽小的
sick	adj. 厭惡的
sicken	v. 使厭倦，使作嘔
siege	n.v. 圍困，圍攻
sigh	n.v. 歎息
significant	adj. 有意義的，重要的
signify	v. 表示，意味著
silica	n. 硅土
silly	adj. 傻的，糊塗的
simulate	vt.偽裝，扮演
simultaneously	adv. 同時的
sin	n. 罪過, 過失
singe	v. 微燒，燙焦
sinister	adj. 邪惡的，不詳的
site	n. 地點
skeptic	n. 懷疑者
skeptical	adj. 懷疑的
sketch	v. 草圖，勾畫
skillful	adj. 熟練的
skim	v. 略讀
skimpy	adj. 吝嗇的，太少的
slacken	v. 鬆弛
slag	n. 渣子
slander	n.v. 造謠，誹謗
slant	n. 斜面，傾斜
slap	v. 掌擊， 拍
slight	adj. 輕微的，微小的
slim	adj. 細長的，苗條的
slippery	adj. 滑的，使人滑跤的
slogan	n. 口號，標語
slope	n. 傾斜，斜面
sloppy	adj. 稀薄的，泥濘的
slovenly	adj. 不潔的，馬虎的
slug	n. 慢吞吞的人
sluggish	adj. 怠惰的
slump	v. 猛然落下
sly	adj. 狡猾的，躲躲閃閃的
smash	v. 破碎
smear	v. 塗，弄髒
smell	v. 發出氣味
smother	v. 使窒息，悶死
snag	n.v. 障礙
snap	v. 猛然斷裂
sneak	v. 潛行
sneer	v. 嘲笑
snobbish	adj. 勢力的，諂上欺下的
sober	adj. 清醒的，適度的
sociable	adj. 友善的，好交際的
sojourn	v.n. 逗留，寄居
solar	adj. 太陽的
sole	adj. 唯一的
solemn	adj. 莊嚴的，隆重的
solicit	v. 懇求，拉客
solicitous	adj. 渴望的，焦慮的
solidly	adv. 牢固的
solitary	adj. 單一的
solitude	n. 與外界隔絕
somewhat	adv. 有點
soothe	v. 安慰，緩和，減輕
souvenir	n. 紀念品
sovereignty	n. 主權
spaceship	n. 太空船
spacious	adj. 廣大的，寬敞的
spawn	v. 產卵
specify	v. 詳述，指定
specimen	n. 標本, 樣品
spectacle	n. 奇觀,景象
spectacular	adj. 引人入勝的， 壯觀的
spectator	n. 旁觀者，觀眾
speculate	v. 推測，沉思
speedy	adj. 快的，迅速的
spew	v. 嘔吐
sphere	n. 球體
spine	n. 脊骨
spineless	adj. 無脊椎的，沒有骨氣的
splash	n.v. 濺,潑
spleen	n.脾臟，
splendid	adj. 燦爛，輝煌的
splendor	n. 光彩，壯麗
spoil	v. 損壞，糟蹋，寵壞
spontaneous	adj. 自發的，本能的
sporadic	adj. 零星的
spot	vt. 認出，地點，污點
spouse	n. 配偶
spout	v. 噴出，湧出
sprawl	v. 擴展，蔓延，伸開手腳
spray	n. 噴霧
spring	n. 泉水， v. 跳躍
sprout	v. 萌芽，長出
spurt	v. 噴出，湧出
squabble	v. 口角，爭論
squad	n. 小隊，班
squander	v. 浪費
square	adj. 正方形的,  n. 平方
squash	v.  壓碎, 南瓜
squeak	n. 吱吱
squeeze	n.v. 擠
stab	v. 刺，戳
stable	adj. 穩定的
staff	n. 全體人員或職員
stagger	v. 蹣跚
stale	adj. 陳腐的
stalk	v. 跟蹤，闊步， n. 莖
stall	n. 廄，攤位
stamina	n. 體力，精力
stand	v. 忍受
startle	v. 大吃一驚
starve	v. 挨餓
static	adj. 靜的， 靜態的
stationary	adj. 固定的
stationery	n. 文具
statistics	n. 統計學
statue	n. 雕像
status	n. 狀況，地位
steadfast	adj. 堅決，堅定, 不變的
steady	adj. 穩步的， v. 使穩定
sterile	adj. 貧瘠的，不育的,  消毒的
stern	adj. 嚴格的，僵化的
sticky	adj. 粘連的
stiff	adj. 硬的，僵直的
still	adv. 依然，靜止
stimulate	v. 刺激，激勵，激發
stingy	adj. 缺乏的，吝嗇的
stipulate	v. 約定，規定
stocky	adj. 結實的，粗短的
stodgy	adj. 難消化的，軀體笨重的
stout	adj. 矮胖的，堅固的
strain	n. 緊張，物種
strait	n. 海峽，困難
strap	n. 皮帶
stray	adj. 漂泊的，走失的
strengthen	v. 加強，鞏固
strenuous	adj. 辛苦的
stride	v. 跨越
strife	n. 衝突，競爭
stringent	adj. 嚴格的，迫切的
strip	v. 剝，奪去， n. 條，帶
strive	v. 努力，奮鬥，力求
stroll	v. 漫步
stubborn	adj. 頑固的
stuffy	adj. 悶熱的，不通風的
stun	v. 使混暈，使目瞪口呆
stunt	v. 阻礙
stunt	n. 驚人的技藝
sturdy	adj. 不屈的，頑強的
subjection	n. 征服，服從
sublimate	v. 使昇華
submerge	v. 淹沒，浸沒
submission	n. 屈服，服從
submissive	adj. 順從的
submit	v. 服從，提交
subordinate	adj. 次要的，附屬的
subsequent	adj. 隨後的，後來的
subsidiary	adj. 支流，輔助的，附屬的
subsist	v. 生存
substantial	adj. 相當的
substantiate	v. 證實，加強
substantive	adj. 實質性的
subtract	v. 減去
subvert	vt. 顛覆，推翻
successful	adj. 成功的
successive	adj. 連續的
succinct	adj. 簡明的，簡潔的
succumb	v. 屈服
sufficient	adj. 足夠的，充分的
suffuse	v. 充滿
suggest	v. 提議，暗示
suitable	adj. 適合的
sullen	adj. 陰沉的
sum	n. 總數，要點
summit	n. 山頂
summon	v. 召喚
superb	adj. 壯麗的，超級的
superficial	adj. 表面的，膚淺的
superintendent	n. 主管，負責人，指揮者
supersede	v. 替代
superstition	n. 迷信
supplant	v. 排擠，取代
supple	adj. 預期的，柔順的
suppose	v. 假象，推測
supreme	adj. 至高的
surmise	v. 預測
surmount	v. 克服，登上，越過
surpass	v. 超過，超越， 勝過
surplus	n. 過剩，剩餘，過剩的
survey	v. 調查
survive	v. 倖免於，活下來
susceptible	adj. 易受感染的
suspect	n. 懷疑，嫌疑犯
suspense	n. 焦慮
suspicion	n. 懷疑
suspicious	adj. 可疑的，猜疑的
sustain	v. 支撐，維持
sustenance	n. 生計，營養物
swarm	n. 群
swell	v. 膨脹
swift	adj. 快速的
symbol	n. 符號
symmetry	n. 對稱，勻稱
sympathetic	adj. 同情的，和諧的
symptom	n. 症狀，症候，徵兆
synchronize	v. 同時發生
synopsis	n. 大綱，梗概
synthetic	adj. 綜合的，合成的
taboo	v.n. 禁忌，禁止
tacit	adj. 心照不宣的，默許的
tackle	v. 處理
tact	n. 老練，機智
tactics	n. 戰術
tag	n. 附加語，標籤
talent	n. 天才，才能，人才
tally	v. 符合
tamper	v. 干預
tangible	adj. 可見的，切實的
tangle	v. 使纏結，使糾纏
tantalize	v. 逗惹，使著急
tardy	adj. 延遲的
tarnish	v. 使晦暗，使敗壞
taste	v. 品味，味道
taunt	v. 嘲笑
tease	v. 逗樂，戲弄，強求
tedious	adj. 冗長乏味的，沉悶的
teem	v. 充滿
temperament	n. 氣質，性情
temperance	n. 節制，自制，戒酒
temperate	adj. 適度的，有節制的
temperature	n. 溫度
temporal	adj. 一時的，暫時的
temporary	adj. 臨時的
tempt	v. 誘使
tenacious	adj. 抓住不放的，頑強的
tenant	n. 租戶，房客
tendency	n. 趨勢
tender	adj. 細心的，考慮周到的，嫩的
tense	n. 時態，adj. 緊張的
tentative	adj. 暫時的，試驗性的
tenuous	adj. 細的，稀薄的
tepid	adj. 微溫的
terminate	v. 終止
terrify	vt. 使恐怖，使驚嚇
terror	n. 恐怖
testify	v. 證明，證實，作證
testimony	n. 證言
textile	n. 紡織物，adj. 紡織的
thaw	v. 使融化，使溶解
theft	n. 偷竊
theoretical	adj. 理論的
thermometer	n. 溫度計
thesis	n. 學位，論文
threaten	vt. 威脅
threshold	n. 門檻
thrift	n. 節約
thrive	v. 繁榮，旺盛
throng	n. 群眾
thrust	vt. 力推
thump	v. 重擊
tide	n. 潮汐，潮流
tilted	v. 傾斜的
timber	n. 木材，木料
timid	adj. 膽怯的，羞怯的
tingle	v. 刺痛，激動
tint	n. 色，染色
tiny	adj. 小的，極小的
tip	v. 跳門，接觸
tissue	n. 組織
titanic	adj. 巨大的， 有力的
toe	n. 腳趾
tolerable	adj. 可容忍的
tolerate	vt. 忍受，容忍，寬恕
toll	n. 稅
toll	v. 鳴
torment	v.n. 痛苦，折磨
torpid	adj. 遲鈍的，不活潑的
torturous	adj. 痛苦的
touching	adj. 動人的，令人感傷的
touchy	adj. 易怒的，棘手的
tow	v. 托引，牽引
tower	n. 塔， 屹立，高聳
trace	n. 痕跡，跟蹤，追溯
tractable	adj. 易架馭的，溫順的
tragedy	n. 悲劇
trait	n. 特點，特性
traitor	n. 叛徒，賣國賊
trample	n. 踐踏，蹂躪
tranquil	adj. 安靜的
transact	v. 處理
transaction	n. 交易
transcend	v. 超越
transcript	n. 成績單
transfix	v. 刺穿
transform	v. 使變形，變換
transient	adj. 短暫的，過路的
transition	n. 轉變，變遷，過渡
transitory	adj. 短暫的
transparent	adj. 透明
transpire	v. 發散，排出，洩漏
trap	v. 誘捕，陷害，陷阱
trash	n. 垃圾
traverse	v. 走過，反對
treason	n. 通敵，叛國罪
treatment	n. 治療
tremble	v. 發抖，搖晃
tremendous	adj. 巨大的，驚人的
tremor	v.n. 顫抖，顫慄
trend	n. 傾向，趨勢
trepidation	n. 驚恐，顫慄
trial	n. 審判，試驗性的
triangle	n. 三角形
trickle	v. 滴，淌，細流
trifling	adj. 微小的
triumph	n. 成功
trivial	adj. 微不足道的
trot	v. 小跑，慢跑
trudge	v. 跋涉, 吃力的走
trying	adj. 難堪的，痛苦的
tug	v. 拖，牽引，拖船
turbulent	adj. 騷動的，騷亂的
turmoil	n. 騷動，混亂
twig	n. 小樹枝
typical	adj. 典型的，有代表性的
ultimate	adj. 最後的
unanimity	n. 全體一致
unanimous	adj. 意見一致的
unbecoming	adj. 不配的，不適當的
unbiased	adj. 公正的
unblemished	adj. 潔白的，無疵的
uncanny	adj. 不可思議的，離奇的
unconscious	adj. 失去知覺的，不察覺的
unconventional	adj. 破例的，自由的
undaunted	adj. 無畏的，勇敢的
underestimate	n. 低估
undertaking	n. 任務，工作
undo	v. 取消，解開，打開
unearth	v. 發掘，發現
unfair	adj. 不公平的
unfortunately	adv. 不幸的
unique	adj. 獨一無二的
universal	adj. 宇宙的，普遍的
universe	n. 宇宙
unruly	adj. 難控制的，不守法的
unseemly	adj. 不適宜的
unshaken	adj. 堅決的，不動搖的
unveil	v. 開幕，揭露
uphold	v. 舉起，支撐
upright	adj. 垂直的，正直的
uprising	v. 叛亂
uproar	n. 騷動，擾亂，喧囂
upset	v. 難過的
urban	adj. 城市的
urge	v. 推進，催促，衝動
urgent	adj. 緊急的，迫切的
useless	adj. 無效的
utility	n. 效用
utilize	v. 利用
vacant	adj. 空的，未被佔用的
vacuum	n. 真空
vague	adj. 模糊的，含糊的
valiant	adj. 英勇的
valid	adj. 有效的，正當的
valor	n. 勇氣
vanish	vt. 消失
vanity	n. 虛榮心
vanquish	v. 征服，克服
variable	n. 變量
variant	adj. 不同的, v. 變量
variation	n. 變化
various	adj. 各種
varnish	n. 油漆
vary	v. 改變
vast	adj. 巨大的，大量的
vault	n. 拱形圓屋頂，地窖
veer	v. 改變方向
vehemence	n. 熱切，激烈
vehement	adj. 猛烈的，激烈的
vein	n. 靜脈，血管, 礦脈
venerate	v. 敬拜，崇拜
ventilation	n. 通風
venture	n.v. 冒險，冒昧
verdict	n. 判決
verify	v. 驗證
versatile	adj. 多才多藝的
verse	n. 詩，韻文
version	n. 說法，版本
vertical	adj. 垂直的
vestige	n. 痕跡，遺跡
veteran	n. 老兵，老手
veto	v. 否決，否決權，禁止
vex	v. 使煩惱
vibration	n. 震動
vigilant	adj. 警惕者的，清醒的
vigor	n. 精力
vigorous	adj. 朝氣蓬勃的
vindicate	v. 辨明，主張
violate	v. 違犯，違背，侵犯
violation	n. 違犯
violent	adj. 激烈的
virtually	adj. 幾乎
virtue	n. 美德
virtuous	adj. 貞節的
vital	adj. 極重要的，生命的
vivid	adj. 生動的
vocation	n. 職業，行業
vogue	n. 流行
void	adj. 空間，空的
volcano	n. 火山
volume	n. 體積，容積
voluntary	adj. 自願的，志願的
volunteer	n. 志願者，adj. 志願的
vote	n.v. 投票
vulgar	adj. 平庸的
vulgarity	n. 粗俗
vulnerable	adj. 易受攻擊的
waddle	v. 蹣跚而行
wade	v. 涉水
wag	v. 搖擺
wand	n. 棒，指揮棒，魔棒
wane	v. 衰減
ware	n. 陶器
warily	adj. 小心的
warn	v. 警告
warrant	v. 保證，權限
warranty	n. 擔保，保證
wary	adj. 機警，小心的
watch	n. 注視，見識，看守
waver	n. 動搖，猶豫
weather	v. 風化，侵蝕
weird	adj. 奇異的
welfare	n. 福利
wheedle	v. 勸誘，哄騙
whim	n. 奇想
whir	v. 急速旋轉
whit	n. 一點
wholesome	adj. 有意健康的
wield	v. 支配，控制
wistful	adj. 渴望的
wit	n. 智力，才智, 智能
withdraw	v. 止回
wither	v. 枯萎，使凋謝
witness	n. 目擊，證人
witty	adj. 機智的，風趣的
worldly	adj. 現世的，世俗的
worthy	adj. 有價值的
wrath	n. 暴怒，狂怒， 憤慨
wring	v. 擰，扭，搾
wry	adj. 諷刺的，歪斜的
yearn	v. 渴望
yell	v. 嚎叫
yelp	v. 喊叫
yen	n. 日元，v. 熱望，渴望
zeal	n. 熱心，熱誠
zealot	n. 熱心者
zealous	adj. 熱心的
zest	n. 濃烈的興趣，熱心
zone	n. 氣候帶